NO ./textures
SO ./textures
WE ./textures
EA ./textures

C 255,255,255
F 0,0,0
1111111111111111111111
1000000000000000000001
100000S000000000000001
1000000000000000000001
1111111111111111111111