
C 55,255,25
NO            ./textures/north_texture.xpm
SO            ./textures/south_texture.xpm
F 0,220,100

WE            ./textures/west_texture.xpm
EA            ./textures/east_texture.xpm

        1111111111111111111111111           1
        1000000000110000000000001            
        101100000111000000000000011111111111
        10010000000000000000N0001
111111111011000001110000000000001
100000000011000001110111111111111
11110111111111011100000010001
11110111111111011101010010001
11000000110111011100000010001
100000000001 10001100000010001
10000000000010001101010010001
10000000000000001100000010001
10000000000000001101010010001
11111111111000000111111111111
           100011
            101
             11111111111111111111111111
