C 225,30,0

NO ./path_to_north_texture.xpm

WE ./path_to_west_texture.xpm

F 220,100,0

EA ./path_to_east_texture.xpm

SO ./path_to_south_texture.xpm
1111111111111111111111111111111
100001                        
10N0011111111111111111111111111    
100001
111111
