NO extures/north.png
SO textures/south.png
WE textures/west.png
EA textures/east.png


C    1,1,2
F  1,220,0

        11111111111111111111111111
        1000000000110000000000001
        101100000111000000000000011111111111
        10010000000000000000N0001
111111111011000001110000000000001
100000000011000001110111111111111
11110111111111011100000010001
11110111111111011101010010001
11000000110111011100000010001
10000000001 10001100000010001
10000000000110001101010010001
10000000000000001100000010001
10000000000000001101010010001
11111111111000000111111111111
           100011
            101
             1