NO                     ./path_to_the_north_texture
F    220,100,0               
SO                  ./path_to_the_south_texture               

C 255,255,255            

WE                 ./path_to_the_east_texture          
EA           ./path_to_the_west_texture

11111111111111111111111111111
11111111101100000111000000001
10000000001100000111011111111
11110111111111011100000010001
11110111111111011101010010001
11000000110101011100000010001
10000000000000001100000010001
10000000000000001101010010001
11000001110101011111011110N01
11110111111101011101111010001
11111111111111111111111111111