NO ./textures/north_texture.xpm
SO ./textures/south_texture.xpm
WE                      ./textures/west_texture.xpm
EA ./textures/east_texture.xpm



C              11,1,1
F  1,220,0

        111111111111111111111111111                                                                             111111111111111111111111111
        1000000000110000000000001                                                                               10000000000000N000000000001
        101100000111000000000000011                                                                             111111111111111111111111111
        1001000000000000000010001
111111111011000001110000000000001
100000000011000001110111111111111
11110111111111011100000010001
11110111111111011101010010001
11000000110111011100000010001
10000000000110001101010010001
1000000000000001100000010001
10000000000000001101010010001
11111111111000000111111111111
           111111100011       1
                10111        1
                 1        1   1