NO                     ./textures/north_texture.xpm
F    220,100,1
SO            ./textures/south_texture.xpm

C 255,255,25
WE                 ./textures/west_texture.xpm
EA           ./textures/east_texture.xpm

        1111111111111111111111111
        1000000000110000000000001
        10110000011100000000000001
        1001000000000000000000001
111111111011000001110000000000001    
100000000011000001110111111111111
11110111111111011100000010001
11110111111111011101010010001
11000000110111011100000010001
100000000001 10001100000010001
10000000000010001101010010001
10000000000000001100000010001
10000000000000001101010010001
11000001110101011111011110N001
11110111 1110101 101111010001
11111111 1111111 111111111111
