NO ./textures/north_texture.xpm
SO ./textures/south_texture.xpm
WE ./textures/west_texture.xpm
EA ./textures/east_texture.xpm


C 255,255,255
F 0,0,0
111111111111111111111
1000000000000000000001
100000S000000000000001
1000000000000000000001
1111111111111111111111
